{
  "name": "第23层",
  "width": 13,
  "height": 13,
  "ground": "ground",
  "bgm": "terror.mp3",
  "mapTerrains": [
    [3, 3, 3, 3, 3, 3, 3, 3, 3, 3, 3, 3, 3],
    [3, 32, 0, 4, 0, 0, 0, 28, 28, 28, 0, 228, 3],
    [3, 4, 0, 82, 0, 4, 4, 4, 4, 4, 4, 0, 3],
    [3, 4, 0, 4, 0, 228, 228, 228, 247, 4, 4, 28, 3],
    [3, 4, 0, 4, 4, 4, 4, 4, 50, 4, 4, 28, 3],
    [3, 4, 0, 63, 4, 4, 4, 4, 4, 4, 247, 0, 3],
    [3, 0, 0, 82, 63, 4, 4, 73, 86, 208, 83, 4, 3],
    [3, 4, 0, 63, 4, 4, 4, 4, 4, 4, 247, 0, 3],
    [3, 4, 0, 4, 4, 4, 4, 4, 50, 4, 4, 28, 3],
    [3, 4, 0, 4, 0, 228, 228, 228, 247, 4, 4, 28, 3],
    [3, 4, 0, 82, 0, 4, 4, 4, 4, 4, 4, 0, 3],
    [3, 32, 0, 4, 0, 0, 0, 28, 28, 28, 0, 228, 3],
    [3, 3, 3, 3, 3, 3, 3, 3, 3, 3, 3, 3, 3]
  ],
  "mapEvents": [
    {
      "x": 1,
      "y": 6,
      "value": 88,
      "events": [
        {
          "type": "loadMap",
          "data": {
            "mapId": "MT22",
            "position": {
              "x": 10,
              "y": 6
            }
          }
        }
      ]
    }
  ]
}
